##############
#     #      #
# $$  #  ..  #
#  $  #  .   #
#   @ #  .   #
# $   #      #
#   $ #  .   #
#     #      #
##############
