################
#     #    .   #
# $$  #  ...   #
#  $  #  .#    #
#  @  ## ##    #
# $      #     #
#   $ #  # $   #
#     #    .   #
################
