############
#    #  .  #
# $  #  .  #
#  $ #  .  #
#   @   $  #
#  $ #     #
# $  #     #
#    #     #
############
