##########
#        #
#  $  .  #
#  $  .  #
#   @    #
##########
