########
#      #
#  $   #
#  @   #
#  .   #
########
