############
#    #     #
# $  # .   #
#  $ #  .  #
#   @#     #
#  $ # .   #
#    #     #
############
